00000000000110000000
00101111101010111110
51100000101110000010
00101111101010111110
00101001001010100100
00111001111011100119
00010010001101001000
00010010110101001000
00011110111101111000
00000000000000000000